[

["#######",
"#....G#",
"###.###",
"#..B..#",
"#.....#",
"#..@..#",
"#######"],

["#######",
"#....G#",
"###.###",
"#..B  #",
"#.....#",
"#..@..#",
"#######"],

["#######",
"#____G#",
"###_###",
"#__V  #",
"#_____#",
"#__@__#",
"#######"],


["#######",
"#R...G#",
"###.###",
"#.B.B.#",
"#..B..#",
"#..@..#",
"#######"],


["#######",
"#..@..#",
"#..B..#",
"###B###",
"#.B.B.#",
"#..L.G#",
"#######"],

["#######",
"###G###",
"##...##",
"#BB.BB#",
"#.BBB.#",
"#B...B#",
"#.BBB.#",
"#..@..#",
"#######"],

["#######",
"# _@_ #",
"#_VVV_#",
"#_ G _#",
"#__V__#",
"# _u_ #",
"#######"],

["######",
"##G###",
"##.###",
"##U###",
"##B###",
"#@B__#",
"#____#",
"######"],

["#########",
"#...D...#",
"#.......#",
"#..B.####",
"#.B@BBB.#",
"#..B_B_U#",
"#..B___.#",
"#..B_##G#",
"#########"],
  
["##########",
"#__V___V_#",
"#__V_V_V_#",
"#__V_@_V_#",
"#######B##",
"#.....LB #",
"#.     . #",
"#G     U #",
"##########"],

[ "###########",
  "##.B....B.#",
  "##B.BBBB.B#",
  "##.B.B..G.#",
  "##B.BB.B.B#",
  "#@.B.B.B.B#",
  "##B.B.B.B.#",
  "###########"]

]
